RA;Fev;Mar;Abr;Mai;Jun;Total Faltas
63227467787;1;2;7;3;5;18
55774275097;0;4;7;4;2;17
76059134116;1;9;8;3;6;27
64295541703;2;2;6;4;6;20
71033266097;2;6;6;5;8;27
94355846566;3;3;6;4;3;19
80830562656;1;7;7;3;1;19
76852042511;3;6;4;4;2;19
91522109945;0;6;3;4;1;14
71863649027;0;2;8;5;0;15
82373740270;3;6;4;4;7;24
57200402542;1;6;6;5;4;22
60126099851;0;9;5;4;0;18
97496463855;3;8;4;4;4;23
68646765054;3;4;5;4;1;17
99843755621;0;8;2;5;2;17
72053544514;0;9;6;3;8;26
63210991357;3;10;4;3;4;24
68082779370;0;8;2;4;4;18
84414508263;0;2;6;3;8;19
88706391022;1;7;6;5;2;21
56156691826;2;9;8;4;2;25
84252161084;1;6;2;5;4;18
73823696006;0;4;2;5;0;11
59249490017;3;8;4;5;2;22
73891810505;1;3;3;5;5;17
61441849541;3;3;8;3;6;23
73782019520;2;5;8;5;7;27
97849217948;2;4;6;4;3;19
84177767225;1;7;7;4;7;26
98294834305;1;5;4;3;7;20
71047234172;3;10;3;3;2;21
82131935084;1;7;3;4;4;19
96097690587;2;3;6;4;4;19
73911690845;0;3;5;3;4;15
96446798045;2;4;2;3;3;14
94220360149;3;10;4;3;1;21
61668710511;3;2;4;5;2;16
90556999713;2;5;7;3;0;17
55798993528;3;6;6;5;7;27
98437267044;3;10;2;3;1;19
89793773870;1;4;6;4;1;16
82100280473;3;7;4;4;0;18
76505149113;0;9;4;4;3;20
79176696752;2;3;6;4;8;23
65353394077;0;6;8;3;8;25
77075884375;0;8;5;5;5;23
81226486449;1;7;4;3;6;21
58427716925;3;5;8;4;1;21
82852392557;2;6;7;5;8;28
78324728693;2;6;8;3;1;20
88082561631;0;5;7;4;5;21
82882234104;0;7;3;4;2;16
58806617325;1;2;7;5;4;19
78853954754;0;9;5;5;0;19
90612351728;1;8;4;5;2;20
61919608954;0;3;5;3;8;19
75846263960;3;6;7;5;4;25
73794741310;0;7;7;4;7;25
69608990923;3;10;8;5;8;34
77449838968;2;5;4;5;5;21
60372750744;2;5;8;3;5;23
99073972248;0;2;4;3;2;11
64281482473;1;2;2;5;6;16
72283032018;0;5;6;4;8;23
98610176591;0;3;8;4;4;19
82514349615;1;8;4;4;0;17
61001960241;1;9;5;5;8;28
58054694485;2;8;5;4;3;22
94936869901;2;5;7;4;5;23
72054138041;3;2;6;3;3;17
75310776795;0;8;8;3;5;24
97240471150;0;8;3;5;6;22
74294082143;0;2;7;5;4;18
68618995444;1;5;3;5;8;22
95468149924;0;5;7;4;5;21
67880375501;0;5;2;5;6;18
67771470327;3;4;3;3;3;16
59814649756;0;6;7;5;4;22
70143824644;2;7;8;5;2;24
96078264778;3;8;2;4;8;25
93436555629;3;9;6;4;7;29
80253593355;0;6;2;4;7;19
75646529999;3;9;2;4;0;18
85152587295;0;10;6;4;8;28
57719656378;1;2;5;4;2;14
58437716952;0;6;8;5;2;21
61835193405;0;2;7;5;3;17
64727719347;2;3;6;5;7;23
95730698265;3;4;3;4;6;20
74226841493;1;10;3;5;0;19
78891245316;3;2;6;4;8;23
86685864800;3;10;8;3;2;26
72184788680;1;9;6;4;1;21
62678402433;0;2;6;4;6;18
95028498771;1;6;3;4;7;21
77590052981;0;4;2;4;8;18
84097442344;2;6;4;4;0;16
87534302801;3;6;4;3;2;18
60915633675;0;6;3;4;0;13
77551235570;3;10;4;5;6;28
91291552109;0;8;5;3;6;22
91607324230;0;8;5;5;1;19
85579223715;1;4;6;4;7;22
89003896358;0;2;7;5;4;18
55896866724;2;10;4;3;6;25
87396313125;3;5;6;5;8;27
57585823373;1;7;5;4;0;17
66289571273;3;2;6;4;3;18
98990966649;1;9;6;5;8;29
65021803315;1;10;6;3;8;28
87802422775;1;7;5;4;8;25
81151693087;1;3;3;5;4;16
90937476478;0;4;7;3;5;19
92546748274;3;10;4;4;4;25
81850742708;0;9;3;3;8;23
95980765400;1;4;2;4;3;14
78549251895;1;6;3;3;3;16
77945547478;0;7;6;5;1;19
83011733706;1;10;6;4;5;26
83006306304;0;10;6;3;8;27
55680472790;2;8;7;4;0;21
75011208424;0;10;4;5;0;19
62953896046;3;4;7;4;8;26
80628296520;3;7;3;3;0;16
83926907902;0;5;5;3;3;16
76709212705;3;5;4;4;3;19
64092642989;0;3;6;4;5;18
56957808904;0;10;3;5;0;18
88649434046;0;10;8;4;1;23
79531250584;0;5;2;4;2;13
57525680626;0;9;7;5;8;29
91889704239;1;6;3;3;3;16
56935443946;2;6;3;3;5;19
66167313279;2;8;4;4;7;25
81361526204;2;8;2;5;4;21
87708947203;1;3;5;5;7;21
63907571633;0;10;7;3;5;25
81885346751;0;7;6;4;5;22
93306105792;3;7;8;5;0;23
97284346100;3;10;3;5;5;26
57249264851;0;8;4;5;7;24
79983949999;0;3;2;4;4;13
99277040765;2;8;6;5;5;26
94356056686;3;5;2;5;7;22
64497873431;0;2;4;4;7;17
78416394568;1;7;8;5;5;26
71966580485;1;8;8;3;3;23
92814941309;3;7;5;5;1;21
55616855724;3;5;4;5;4;21
90016805947;3;5;8;4;4;24
81946383101;2;5;6;5;2;20
99668234269;2;8;4;5;8;27
78541742773;1;5;7;3;6;22
76005698603;0;8;4;3;1;16
67592796415;3;3;5;3;1;15
87358837817;2;3;5;5;3;18
69261074960;3;2;4;4;3;16
88717881455;2;8;4;3;2;19
56682750405;2;4;4;3;8;21
94661035036;0;6;3;5;8;22
80007068125;2;7;6;4;7;26
93337030792;1;8;4;5;1;19
98015855059;1;3;5;3;0;12
99554681418;0;6;3;4;2;15
58824953664;2;5;2;4;6;19
88420471730;3;4;5;4;2;18
89753204608;1;4;3;5;4;17
90202411846;0;8;6;5;8;27
81270830371;1;4;7;4;2;18
66377269361;3;5;5;5;8;26
58149644619;0;2;4;4;0;10
66591401813;2;5;6;4;4;21
65765753264;3;8;3;4;6;24
82526148869;3;7;5;5;7;27
90309914050;1;3;3;4;1;12
83975379628;1;6;8;5;3;23
66661633537;0;5;8;3;8;24
61583920765;3;10;4;5;3;25
62123716594;3;4;8;5;0;20
84576082462;1;2;3;3;4;13
76397496949;0;3;6;3;5;17
57500064385;2;7;6;5;4;24
70054158612;1;9;5;3;7;25
97864881365;1;4;3;4;2;14
84701642018;2;8;2;4;6;22
66520770222;0;9;7;5;5;26
93867800997;0;4;4;5;0;13
97553346924;1;9;5;3;4;22
81005826445;2;10;3;4;2;21
99058766380;1;3;6;5;5;20
75679584507;2;9;7;4;2;24
65910449155;3;4;2;4;2;15
57129783197;0;7;7;3;2;19
75212790666;0;6;5;3;7;21
92971053189;2;8;3;3;1;17
61231871495;2;6;7;5;3;23
57150917852;1;3;8;5;4;21
98697853336;1;7;7;4;8;27
58912360748;0;10;3;4;7;24
95789459920;1;9;7;5;7;29
67495034437;2;3;4;5;8;22
94181295850;1;8;2;3;5;19
71774966528;3;2;5;5;3;18
92514746471;3;8;8;3;6;28
64023556397;2;8;5;4;8;27
93220030662;0;3;8;5;1;17
64834744744;1;5;2;4;5;17
97266315766;0;4;4;4;4;16
61818444647;3;6;6;3;3;21
91593744313;3;2;6;3;1;15
86983369387;2;2;6;4;2;16
62425838632;0;7;2;5;8;22
90887685686;1;8;2;3;7;21
80818216300;0;6;7;4;3;20
70913174333;0;2;3;4;3;12
73171353709;0;4;4;4;1;13
99478075629;0;9;8;3;0;20
82950348580;3;2;3;4;4;16
75811422535;3;5;5;4;3;20
59992394107;1;10;4;3;0;18
61123299597;3;3;6;3;7;22
85829880750;2;5;8;5;7;27
71981991451;0;5;5;3;6;19
75371578775;3;4;2;4;7;20
66825609138;0;7;3;3;0;13
60302141496;0;9;2;5;8;24
74696150320;0;8;3;4;8;23
60533949567;3;10;4;5;1;23
63528419604;2;9;5;4;7;27
68716425599;1;3;7;3;2;16
93795650965;1;7;2;3;2;15
88726960254;3;4;8;3;3;21
89549710801;3;8;7;5;5;28
73056953742;0;4;6;5;0;15
82562254871;0;5;6;4;5;20
72175054968;3;2;4;4;7;20
73232572919;2;8;3;5;8;26
70459266656;0;5;5;5;1;16
72340937537;1;8;3;3;1;16
98177664836;0;8;3;3;4;18
68885567947;1;10;4;5;3;23
82536911321;1;4;5;5;7;22
77472036374;1;8;3;5;3;20
88725538553;1;3;3;5;5;17
90403549025;0;2;6;3;4;15
80925212572;2;5;5;5;8;25
89377636199;0;7;5;4;6;22
86525690894;0;5;5;4;1;15
97364081212;1;2;2;5;6;16
89804698120;1;5;4;5;1;16
86941202761;0;9;4;5;6;24
68954599741;2;10;5;4;0;21
75366354164;1;7;2;5;7;22
69608866653;0;6;4;4;3;17
64928767418;3;3;5;3;0;14
88501881981;1;5;2;3;2;13
70982644387;0;9;8;4;3;24
68610098906;2;5;6;4;6;23
80014803890;0;8;7;5;7;27
67380702151;3;4;5;5;1;18
79819361962;1;7;3;4;3;18
90396632443;0;9;3;5;5;22
79667586565;1;10;7;5;8;31
74962199967;2;3;2;5;2;14
96481026526;1;9;3;4;4;21
73333039512;3;3;6;3;3;18
96377476121;1;7;5;4;3;20
57039255807;3;10;4;4;3;24
63093566834;3;4;8;4;8;27
88482887885;0;9;8;4;7;28
97950320482;0;6;6;5;7;24
56843204394;2;3;7;4;1;17
99532054279;1;3;3;5;8;20
57029100687;3;6;8;3;8;28
82487546449;1;7;7;4;2;21
74652879976;0;8;3;4;8;23
84788367355;1;10;4;4;5;24
76288685079;2;8;6;5;1;22
69937104197;3;10;5;3;7;28
78051129659;3;9;2;5;0;19
76858653145;3;7;6;4;1;21
63119744731;0;7;3;3;0;13
72100652952;3;3;4;3;5;18
76533280860;0;5;4;5;2;16
57880527806;3;7;7;3;3;23
65092064021;0;8;6;3;5;22
63893561511;0;4;6;5;7;22
84291839162;1;7;8;5;2;23
80113300098;2;4;4;3;0;13
59463043646;2;4;5;4;5;20
75332205879;0;7;2;4;7;20
80967326985;0;2;5;5;3;15
64145893892;0;7;7;4;3;21
58534624387;3;4;5;5;2;19
80355209504;3;5;5;4;6;23
64876344668;2;4;4;5;5;20
77611509140;1;9;8;4;2;24
61821096538;1;5;6;3;6;21
92179223683;2;4;8;5;8;27
